####################
#                  #
#                  #
#                  #
#                  #
#                  #
#                  #
#                  #
#                  #
#                  #
#      #######     #
#                  #
#  ##          ##  #
# 1             2  #
####################
